\bmember\s+of\s+the\s+institution\s+of\s+engineers\s+australia\b	mieaust
\bofficer\s+of\s+the\s+order\s+of\s+australia\b	ao
\baustralian\s+capital\s+territory\b	act
\bjervis\s+bay\s+territory\b	jbt
\bmember\s+of\s+parliament\b	mp
\bproprietary\s+limited\b	pty ltd
\blower\s+ground\s+floor\b	lg
\bnorthern\s+territory\b	nt
\bupper\s+ground\s+floor\b	ug
\bwestern\s+australia\b	wa
\bbachelor\s+of\s+arts\b	ba
\bnew\s+south\s+wales\b	nsw
\bsouth\s+australia\b	sa
\bground\s+floor\b	g
\bincorporated\b	inc
\bmarine\s+berth\b	mb
\bno\s+liability\b	nl
\bproprietary\b	pty
\bboulevarde\b	bvd
\bhonourable\b	hon
\bqueensland\b	qld
\bapartment\b	apt
\baustralia\b	au
\bboulevard\b	bvd
\besplanade\b	esp
\bmezzanine\b	m
\bwarehouse\b	we
\bbasement\b	b
\bcrescent\b	cres
\breverend\b	rev
\btasmania\b	tas
\bvictoria\b	vic
\bcircuit\b	cct
\bcompany\b	co
\bfactory\b	fy
\bhighway\b	hwy
\blimited\b	ltd
\bparkway\b	pkwy
\bterrace\b	tce
\barcade\b	arc
\bau\-act\b	act
\bau\-jbt\b	jbt
\bau\-nsw\b	nsw
\bau\-qld\b	qld
\bau\-tas\b	tas
\bau\-vic\b	vic
\bavenue\b	ave
\bcommon\b	comm
\bdoctor\b	dr
\bmister\b	mr
\boffice\b	off
\bparade\b	pde
\bsquare\b	sq
\bstreet\b	st
\ba\s+c\s+t\b	act
\balley\b	ally
\bau\-nt\b	nt
\bau\-sa\b	sa
\bau\-wa\b	wa
\bclose\b	cl
\bcourt\b	ct
\bdrive\b	dr
\bfloor\b	fl
\bgrove\b	gr
\bj\s+b\s+t\b	jbt
\blevel\b	l
\bmount\b	mt
\bn\s+s\s+w\b	nsw
\bnorth\b	n
\bplace\b	pl
\bpoint\b	pt
\bsaint\b	st
\bsouth\b	s
\bstall\b	sl
\bsuite\b	se
\bblvd\b	bvd
\beast\b	e
\bflat\b	f
\blane\b	ln
\broad\b	rd
\broom\b	rm
\bunit\b	u
\bwest\b	w
\band\b	&
\baus\b	au
\bn\s+t\b	nt
\bnth\b	n
\bs\s+a\b	sa
\bsth\b	s
\bw\s+a\b	wa
\bun\b	u
