\b([a-z]+)(gade|vej|torv|plads|pladsen|alle|anlaeg|bakken|banen|bastion|boulevard|bro|buen|dammen|gaard|gangen|get|graensen|have|hojen|hoj|holmen|huset|kaer|kraenten|laengen|marken|parken|passagen|siden|stien|straede|svinget|toften|vangen|varden|vaenge)(\s[a-z0-9]+)?$\b	\1 \2 \3
\b(\s|^|[a-z]+)(motor|hoved|motortrafik)\s(vej)(\s|$)\b	\1 \2\3\4
\bgrabrodrestraede\b	grabrodrestr
\barnold\s+nielsens\b	arn nielsens
\bhaveforeningen\b	f
\bground\s+floor\b	st
\bhaveforening\b	f
\bbispebjergs\b	bispebjerg
\bdosseringen\b	dossering
\btengslemark\b	tengslemrk
\btil\s+venstre\b	tv
\bboulevard\b	boul
\bkaelderen\b	kld
\btil\s+h√∏jre\b	th
\bbasement\b	kld
\bfacility\b	anlaeg
\bgraensen\b	border
\bkraenten\b	slope
\blillerod\b	allerod
\bmidt\s+for\b	mf
\bpassagen\b	passage
\bdanmark\b	dk
\bdenmark\b	dk
\bkvarter\b	kvater
\blaengen\b	long
\bpladsen\b	plads
\bstraede\b	strait
\bavenue\b	alle
\bbakken\b	hill
\bboulev\b	boul
\bbridge\b	bro
\bdammen\b	pond
\bgammel\b	gl
\bgarden\b	have
\bharbor\b	havn
\bholmen\b	islet
\blokken\b	lokke
\bmarken\b	field
\bmiddle\b	mf
\bnummer\b	nr
\bparken\b	park
\bsondre\b	s
\bsquare\b	torv
\bvaenge\b	wing
\bvangen\b	prison
\bvarden\b	cairn
\bbroen\b	bro
\betage\b	flr
\bfloor\b	flr
\bgaard\b	yard
\bgamle\b	gl
\bhuset\b	house
\bmound\b	hojen
\bnorre\b	n
\bright\b	th
\bsankt\b	sct
\bstien\b	path
\bstuen\b	st
\btrack\b	banen
\bbuen\b	bow
\bhigh\b	hoj
\bleft\b	tv
\bnord\b	n
\bvest\b	v
\bndr\b	n
\bost\b	o
\bsdr\b	s
\bskt\b	sct
\bsyd\b	s
