\bfriedrich\s+robert\s+faehlmanni\b	faehlmanni
\bkarl\s+ernst\s+von\s+baer\b	k. e.von baeri
\bfr\.\s+r\.\s+faehlmanni\b	faehlmanni
\bf\.\s+r\.\s+faehlmanni\b	faehlmanni
\bkristjan\s+karberi\b	k. karberi
\bforest\s+district\b	mk
\bk\.\s+e\.\s+von\s+baeri\b	k. e.von baeri
\bdumping\s+ground\b	prugila
\bf\.r\.faehlmanni\b	faehlmanni
\bk\.e\.\s+von\s+baeri\b	k. e.von baeri
\bmunicipal\s+hall\b	vlm
\bborder\s+guard\b	prv
\beduard\s+vilde\b	e. vilde
\bsidejaoskond\b	sjsk
\bpost\s+office\b	sjsk
\bkrossirada\b	kross
\bmain\s+ditch\b	kr
\bpiirivalve\b	prv
\bpoikuulits\b	lane
\bboulevard\b	tn
\bcrossroad\b	lane
\bcrosswalk\b	kross
\bprugimagi\b	prugila
\bvallamaja\b	vlm
\bveehoidla\b	vh
\bforeland\b	n
\bmetskond\b	mk
\bpeakraav\b	pkr
\bpoolsaar\b	ps
\bpuiestee\b	tn
\bchannel\b	kan
\bhighway\b	mnt
\bmaantee\b	mnt
\brailway\b	rdt
\braudtee\b	rdt
\bavenue\b	tn
\bisland\b	s
\bkanali\b	kan
\blaanes\b	w
\bparish\b	vlm
\bsquare\b	pl
\bstreet\b	tn
\bvaljak\b	vk
\bvalley\b	org
\bbrook\b	j
\bcanal\b	kr
\bfield\b	pold
\bhouse\b	vlm
\bkaare\b	arch
\bkanal\b	kan
\bkraav\b	kr
\blouna\b	s
\bnorth\b	n
\bplain\b	pold
\bplats\b	pl
\bpohja\b	n
\briver\b	j
\bsadam\b	sd
\bsouth\b	s
\btanav\b	tn
\bcape\b	n
\bcove\b	l
\beast\b	e
\bhill\b	m
\bitta\b	e
\bjarv\b	jv
\bjogi\b	j
\bkaar\b	arch
\blaht\b	l
\blake\b	jv
\bmagi\b	m
\bneem\b	n
\bpoik\b	lane
\bpond\b	tk
\bport\b	sd
\broad\b	mnt
\bsaar\b	s
\btalu\b	t
\btiik\b	tk
\bwest\b	w
\bbay\b	l
\bpst\b	tn
\bway\b	tee
\be\.\b	e
\bn\.\b	n
\bs\.\b	s
\bw\.\b	w
