\bcarretera\s+dera\s+circunvalacio\b	aut
\bsanta\s+cruz\s+de\s+tenerife\b	tf
\bcarrero\s+sense\s+sortida\b	tzucac
\bcarrer\s+sense\s+gessuda\b	tzucac
\bcarrer\s+sense\s+sortida\b	tzucac
\bcallejon\s+sin\s+salida\b	tzucac
\bcarretera\s+nacional\b	aut
\bbalearic\s+islands\b	pm
\bpont\s+de\s+vianants\b	zaldain
\bpuente\s+peatonal\b	zaldain
\bcircunvalacion\b	aut
\bislas\s+baleares\b	pm
\bnuestra\s+senora\b	ntra s
\bpont\s+de\s+pedons\b	zaldain
\bcasa\s+de\s+campo\b	cottage
\billes\s+balears\b	pm
\brua\s+sen\s+saída\b	tzucac
\bayuntamiento\b	ayto
\bbidegurutzea\b	cruce
\bbiribilgunea\b	rotonda
\bcasa\s+de\s+camp\b	cottage
\bdesbideratze\b	desvio
\binterseccion\b	cruce
\bintersection\b	cruce
\bautoestrada\b	aut
\bciudad\s+real\b	cr
\bencreuament\b	cruce
\bguadalajara\b	gu
\binterseccio\b	cruce
\bntra\s+senora\b	ntra s
\bnuestra\s+sra\b	ntra s
\bside\s+street\b	travesia
\bcasa\s+rural\b	cottage
\bcomandante\b	cte
\bdesviament\b	desvio
\belkargunea\b	cruce
\benparantza\b	pl
\bfootbridge\b	zaldain
\bkalea\s+itsu\b	tzucac
\bla\s+corunna\b	c
\bla\s+corunya\b	c
\blas\s+palmas\b	gc
\bpasealekua\b	av
\bpontevedra\b	po
\broundabout\b	rotonda
\btrauessera\b	travesia
\btravessera\b	travesia
\bvalladolid\b	va
\bzeharbidea\b	travesia
\bzeharkalea\b	travesia
\bautobidea\b	aut
\bautopista\b	aut
\bbarcelona\b	b
\bboulevard\b	rambla
\bbulevarra\b	rambla
\bcantabria\b	s
\bcarretera\b	ctra
\bcastellon\b	cs
\bcrossroad\b	cruce
\berrepidea\b	ctra
\berrotonda\b	rotonda
\besplugues\b	esplugas
\betorbidea\b	av
\bguipuscoa\b	ss
\bguipuzcoa\b	ss
\bhiribidea\b	rambla
\bibilbidea\b	rota
\bkale\s+itsu\b	tzucac
\bla\s+coruna\b	c
\bnuestra\s+s\b	ntra s
\bpasabidea\b	zaldain
\bpasalekua\b	cjon
\breverendo\b	rvdo
\bsalamanca\b	sa
\bsaragossa\b	z
\btarragona\b	t
\btravessia\b	travesia
\bway\s+above\b	aldapa
\bway\s+below\b	cta
\bzeharbide\b	travesia
\bzeharkale\b	travesia
\ba\s+coruna\b	c
\balbacete\b	ab
\balicante\b	a
\balleyway\b	cjon
\basturias\b	o
\bavenguda\b	av
\bavinguda\b	av
\bbaishada\b	aldapa
\bbarriada\b	bda
\bbulevard\b	rambla
\bcallejon\b	cjon
\bcastello\b	cs
\bcastillo\b	castle
\bcrossing\b	cruce
\bdead\s+end\b	tzucac
\bestacion\b	est
\bgaztelua\b	castle
\bgipuzkoa\b	ss
\bhorcadís\b	cruce
\biglasias\b	iglesia
\bla\s+rioja\b	lo
\blandetxe\b	cottage
\bmotorway\b	aut
\bnafarroa\b	na
\bntra\s+sra\b	ntra s
\bpalencia\b	p
\bpasabide\b	zaldain
\bpasarela\b	zaldain
\bpassatge\b	cjon
\bvalencia\b	v
\bway\s+down\b	aldapa
\bzaragoza\b	z
\balacant\b	a
\balmeria\b	al
\bautobia\b	aut
\bautovia\b	aut
\bavenida\b	av
\bbadajoz\b	ba
\bbaixada\b	aldapa
\bbizkaia\b	bi
\bbulevar\b	rambla
\bcaceres\b	cc
\bcalexon\b	cjon
\bcapitan\b	cap
\bcarrero\b	cjon
\bcastell\b	castle
\bcastelo\b	castle
\bcasteth\b	castle
\bcordoba\b	co
\bcordova\b	co
\bcoronel\b	cnel
\bcruilla\b	cruce
\bdoctora\b	dra
\bestrada\b	ctra
\bgaztelu\b	castle
\bgeneral\b	gral
\bgranada\b	gr
\bhighway\b	aut
\bkalexka\b	cjon
\bkarrika\b	c
\bnavarra\b	na
\bnavarre\b	na
\bourense\b	or
\bpassage\b	cjon
\bpasseig\b	av
\bsegovia\b	sg
\bsevilla\b	se
\bseville\b	se
\bvizcaya\b	bi
\bacceso\b	acc
\bavenue\b	av
\bbajada\b	aldapa
\bbarrio\b	b
\bbiscay\b	bi
\bbridge\b	pont
\bburgos\b	bu
\bcamino\b	c
\bcarrer\b	c
\bcarret\b	ctra
\bcarril\b	carr
\bcoruna\b	c
\bcuenca\b	cu
\bcuesta\b	cta
\bdetour\b	desvio
\bdoctor\b	dr
\bespana\b	es
\bgerona\b	gi
\bgirona\b	gi
\bhuelva\b	h
\bhuesca\b	hu
\bigoera\b	cta
\blerida\b	l
\blleida\b	l
\bmadrid\b	m
\bmalaga\b	ma
\bmurcia\b	mu
\borense\b	or
\bpasaje\b	cjon
\bpasseg\b	av
\bpuente\b	pont
\bpujada\b	cta
\bsenora\b	sra
\bsquare\b	pl
\bstreet\b	c
\bsubida\b	cta
\bteruel\b	te
\btoledo\b	to
\btunela\b	tunel
\btunnel\b	tunel
\bway\s+up\b	cta
\bzamora\b	za
\balava\b	vi
\baraba\b	vi
\bavila\b	av
\bbarda\b	bda
\bbarri\b	b
\bbarro\b	b
\bbeato\b	bto
\bbidea\b	c
\bcadiz\b	ca
\bcalle\b	c
\bcamin\b	c
\bcomte\b	cte
\bcosta\b	cta
\bkalea\b	c
\bnorte\b	n
\bnorth\b	n
\boeste\b	o
\bpaseo\b	av
\bplaca\b	pl
\bplaza\b	pl
\bponte\b	pont
\bpraza\b	pl
\broute\b	rota
\bsanta\b	sta
\bsanto\b	sto
\bsenor\b	se
\bsoria\b	so
\bsouth\b	s
\bspain\b	es
\bxeito\b	c
\bzubia\b	pont
\bavda\b	av
\bcami\b	c
\bcmdt\b	cte
\bcmte\b	cte
\beast\b	e
\beste\b	e
\bjaen\b	j
\blane\b	c
\bleon\b	le
\blugo\b	lu
\bpaso\b	cjon
\bpath\b	c
\broad\b	ctra
\bruta\b	rota
\bsant\b	st
\bwest\b	o
\bavd\b	av
\bc\s+/\b	c
\bpza\b	pl
\brua\b	c
\bsur\b	s
\bway\b	c
\bbo\b	b
\bc/\b	c
