\b([a-z]+)(vag(en)?|katu|alle|aveny|polku|reitti|maantie|kuja|alue|kaari|kyla|penger|puistikko|puisto|raitti|brink(en)?|bygata(n)?|led(en)?|park(en)?|stig(en)?|strand(en)?|torg(et)?)\b	\1 \2
\b([a-z]+)(mt|metsatie|gata(n)?|krok(en)?|grandet|grand(et)?)\b	\1 \2
\b([a-z]+)(kaista|piha|tie(n)?)\b	\1 \2
\bkahdeskymmenesensimmäinen\b	21
\byhdeksäskymmenes\b	90
\betelainen\b	e
\bnortheast\b	koillinen
\bnorthwest\b	kaakko
\bpohjoinen\b	p
\bpuistikko\b	pko
\bsoutheast\b	lounas
\bsouthwest\b	luode
\bmetsatie\b	mt
\bstranden\b	str
\bbrinken\b	br
\bbygatan\b	bg
\bfinland\b	fi
\bgranden\b	gr
\bskvaret\b	skv
\bstraket\b	sk
\basunto\b	as
\bbostad\b	bst.
\bbygata\b	bg
\bkerros\b	krs
\bparken\b	pk
\bpenger\b	pgr
\bpuisto\b	ps
\braitti\b	r
\bstigen\b	st
\bstrand\b	str
\btorget\b	tg
\baukio\b	auk
\bbrink\b	br
\betela\b	e
\bgrand\b	gr
\bkaari\b	kri
\blansi\b	l
\bleden\b	l
\bnorth\b	p
\bskvar\b	skv
\bsouth\b	e
\bstrak\b	sk
\bsuomi\b	fi
\balue\b	al
\beast\b	i
\bgata\b	g
\bkatu\b	k
\bkuja\b	kj
\bkyla\b	kl.
\bpark\b	pk
\bstig\b	st
\btien\b	tie
\btorg\b	tg
\bwest\b	l
\bita\b	i
\bled\b	l
\bvag\b	v
