\blouis\s+antoine\s+bougainville\b	l a bougainville
\bprovence\s+alpes\s+cote\s+d\s+azur\b	u
\bzone\s+amenagament\s+concerte\b	zac
\bdivision\s+francaise\s+libre\b	dfl
\blantoine\s+de\s+bougainville\b	l a bougainville
\bzone\s+amenagament\s+differe\b	zad
\barnouville\s+les\s+gonesse\b	arnouville
\blouis\s+camille\s+maillard\b	louis maillard
\bjean\s+francois\s+millet\b	francois millet
\blanguedoc\s+roussillon\b	k
\bl\s+a\s+de\s+bougainville\b	l a bougainville
\bnord\s+pas\s+de\s+calais\b	o
\balbert\s+schweitzer\b	schweitzer
\bcentre\s+commercial\b	ccal
\bchampagne\s+ardenne\b	g
\bzone\s+industrielle\b	zi
\bdivision\s+blindee\b	db
\bgeorges\s+guynemer\b	g guynemer
\bpays\s+de\s+la\s+loire\b	r
\bpierre\s+corneille\b	corneille
\bpoitou\s+charentes\b	t
\bbasse\s+normandie\b	p
\bhaute\s+normandie\b	q
\brobert\s+schumann\b	robert schuman
\bantoine\s+chanzy\b	a chanzy
\bcharles\s+gaulle\b	gaulle
\bdepartementale\b	d
\blower\s+normandy\b	p
\bupper\s+normandy\b	q
\byouri\s+gagarine\b	gagarine
\bblaise\s+pascal\b	pascal
\bdepartemental\b	d
\bfranche\s+comte\b	i
\bile\s+de\s+france\b	j
\blouis\s+lumiere\b	lumiere
\blouis\s+pasteur\b	pasteur
\bmidi\s+pyrenees\b	n
\bzone\s+activite\b	za
\bcorse\s+du\s+sud\b	2a
\bappartement\b	app
\bbaraquement\b	brq
\bcouffouleux\b	coufouleux
\bhaute\s+corse\b	2b
\bjean\s+monnet\b	jean monet
\blotissement\b	lot
\brhone\s+alpes\b	v
\bround\s+point\b	rpt
\bacquitaine\b	b
\beuropeenne\b	e route
\buniversite\b	univ
\baerodrome\b	aerd
\bapartment\b	app
\baquitaine\b	b
\bautoroute\b	a
\bboulevard\b	bd
\bbourgogne\b	d
\bnationale\b	n
\bresidence\b	res
\bseptembre\b	sept
\baerogare\b	aerg
\baeroport\b	aerp
\ballemont\b	allemond
\bauvergne\b	c
\bbatiment\b	bat
\bbretagne\b	e
\bbrittany\b	e
\bbuilding\b	bat
\bburgundy\b	d
\bdecembre\b	dec
\bespanade\b	esp
\bflemming\b	fleming
\bimmeuble\b	imm
\bla\s+croix\b	lacroix
\blimousin\b	l
\blorraine\b	m
\bnational\b	n
\bnovembre\b	nov
\bpicardie\b	s
\bquartier\b	qua
\bcorsica\b	h
\bdragons\b	dragon
\bfevrier\b	fevr
\bgrandes\b	gd
\bimpasse\b	imp
\bjanvier\b	janv
\bjuillet\b	juil
\boctobre\b	oct
\bpassage\b	pas
\bpicardy\b	s
\bsentier\b	sent
\bservice\b	sce
\bagence\b	agce
\balsace\b	a
\bavenue\b	av
\bcarrer\b	cae
\bcentre\b	f
\bchemin\b	chem
\bfrance\b	fr
\bgrande\b	gd
\bhautes\b	ht
\bsainte\b	st
\bsquare\b	sq
\btunnel\b	tun
\ballee\b	all
\bcorse\b	h
\bcours\b	cour
\bd\s+f\s+l\b	dfl
\bforet\b	for
\bgrand\b	gd
\bhaute\b	ht
\bhauts\b	ht
\bhotel\b	hot
\bmount\b	mt
\bnorth\b	n
\bouest\b	o
\bplace\b	pl
\broute\b	rte
\bsaint\b	st
\bsouth\b	s
\bvilla\b	vil
\bctre\b	f
\beast\b	e
\bhaut\b	ht
\bhtes\b	ht
\bnord\b	n
\bpass\b	pas
\bwest\b	o
\bave\b	av
\best\b	e
\bgde\b	gd
\bgds\b	gd
\bhte\b	ht
\bhts\b	ht
\bmte\b	mt
\brua\b	rte
\brue\b	rte
\bste\b	st
\bsud\b	s
\bgr\b	gd
\bw\b	o
