\bjacobo\s+arbenz\s+guzman\b	jacob arbenz
\bapartado\s+de\s+correos\b	po box
\binterconnection\b	interconexion
\bjacobo\s+arbenz\b	jacob arbenz
\bruta\s+nacional\b	rn
\bcase\s+postale\b	po box
\bdepartamento\b	depto
\bprincipale\b	main
\bsecondaire\b	secondary
\bsecundaria\b	secondary
\bautoroute\b	ca
\bboulevard\b	blvd
\bcarretera\b	ca
\bnortheast\b	noreste
\bnorthwest\b	noroeste
\boccidente\b	o
\bprincipal\b	main
\bsoutheast\b	sureste
\bsouthwest\b	suroeste
\bbuilding\b	edif
\bdiagonal\b	diag
\bdistrict\b	barrio
\bedificio\b	edif
\bquartier\b	barrio
\bavenida\b	av
\bbulevar\b	blvd
\bhighway\b	ca
\boriente\b	e
\bprimary\b	main
\bseccion\b	sec
\bsection\b	sec
\bavenue\b	av
\bcamino\b	road
\bcarret\b	ca
\bciudad\b	city
\bmaison\b	edif
\bpuerta\b	pta
\bregion\b	depto
\bstreet\b	c
\bcalle\b	c
\betage\b	piso
\bfloor\b	piso
\bmajor\b	main
\bnorte\b	n
\bnorth\b	n
\boeste\b	o
\bporte\b	pta
\broute\b	ruta
\bsouth\b	s
\bville\b	city
\baile\b	ala
\bdoor\b	pta
\beast\b	e
\beste\b	e
\blote\b	lot
\btown\b	city
\bwest\b	o
\bwing\b	ala
\bave\b	av
\bsur\b	s
