\bjama'at\s+izalatul\s+bidi'a\s+wa'ikamatus\s+sunnah\b	jibwis
\bnigerian\s+national\s+petroleum\s+corporation\b	nnpc
\buniversity\s+of\s+nigeria\s+teaching\s+hospital\b	unth
\bfederal\s+capital\s+development\s+authority\b	fcda
\bnigerian\s+telecommunications\s+limited\b	nitel
\bpower\s+holding\s+company\s+of\s+nigeria\b	phcn
\bredeemed\s+christian\s+church\s+of\s+god\b	rccg
\bevangelical\s+church\s+winning\s+all\b	ecwa
\bfederal\s+road\s+safety\s+commission\b	frsc
\bfederal\s+government\s+of\s+nigeria\b	fgn
\bnigerian\s+television\s+authority\b	nta
\babuja\s+municipal\s+area\s+council\b	amac
\bchristian\s+missionary\s+society\b	cms
\buniversity\s+of\s+nigeria\s+nsukka\b	unn
\buniversity\s+college\s+hospital\b	uch
\bnational\s+union\s+of\s+teachers\b	nut
\bfederal\s+capital\s+territory\b	fct
\bfederal\s+housing\s+authority\b	fha
\bfederal\s+ministry\s+of\s+work\b	fmw
\bpublic\s+liability\s+company\b	plc
\bcentral\s+bank\s+for\s+africa\b	cba
\bcentral\s+bank\s+of\s+nigeria\b	cbn
\bchief\s+executive\s+officer\b	ceo
\bnigerian\s+postal\s+service\b	nipost
\bnational\s+union\s+teacher\b	nut
\bunited\s+bank\s+for\s+africa\b	uba
\bfirst\s+bank\s+of\s+nigeria\b	fbn
\blocal\s+government\s+area\b	lga
\bcounter\s+extension\b	ce
\bnational\s+assembly\b	nass
\bvoice\s+of\s+nigeria\b	von
\bcommunication\b	comm
\binternational\b	int'l
\bport\s+hartourt\b	ph
\bheadquarters\b	hqtrs
\bagriculture\b	agric
\bcooperative\b	coop
\bdevelopment\b	dev
\binstitution\b	instn
\bsecretariat\b	sect
\bcommission\b	com
\btelevision\b	tv
\bboulevard\b	blvd
\bhonorable\b	hon
\binstitute\b	inst
\binsurance\b	ins
\bsecondary\b	scdry
\btechnical\b	tech
\bcrescent\b	cr
\bdivision\b	div
\bhospital\b	hosp
\bministry\b	min
\bmohammed\b	mohd
\bcollege\b	coll
\bcompany\b	coy
\bexpress\b	exp
\bgrammar\b	gram
\bhighway\b	hwy
\blibrary\b	lib
\blimited\b	ltd
\bnigeria\b	ng
\bsenator\b	sen
\bvillage\b	vill
\bavenue\b	av
\bchurch\b	ch
\bestate\b	est
\bmarket\b	mkt
\bmister\b	mr
\bnumber\b	#
\bschool\b	sch
\bstreet\b	st
\bbeach\b	bh
\bblock\b	blk
\bclose\b	cl
\bdrive\b	dr
\bbelt\b	bt
\blane\b	ln
\bline\b	lne
\blink\b	lk
\broad\b	rd
\bave\b	av
\bno\.\b	#
\bnum\b	#
\bstr\b	st
\bno\b	#
