\beuropean\s+road\b	e
\båtte\s+hundrede\b	8
\båtte\s+hundreog\b	8
\bintersection\b	crossing
\bmain\s+riksveg\b	r
\bcarriageway\b	kjorebane
\bcounty\s+road\b	f
\brundkjoring\b	roundabout
\bfootbridge\b	gangbro
\bcity\s+wall\b	bymur
\bcrossroad\b	crossing
\beuropavei\b	e
\bfylkesvei\b	f
\bomkjoring\b	detour
\balleyway\b	lane
\bdead\s+end\b	blindvei
\bfootpath\b	gangsti
\blandevei\b	highway
\bmotorway\b	motorvei
\bnorthern\b	n
\bpassasje\b	passage
\bpostboks\b	pb
\bsouthern\b	s
\bstairway\b	trapp
\bterrasse\b	terrace
\bvegkryss\b	crossing
\båttiende\b	8
\bbakgate\b	lane
\bcottage\b	hytte
\beastern\b	e
\bplassen\b	pl
\briksvei\b	r
\bringvei\b	r
\bstredet\b	strait
\bsvingen\b	turn
\btrapper\b	trapp
\bwestern\b	w
\båttende\b	8
\balleen\b	alle
\baustre\b	e
\bavenue\b	alle
\bbakken\b	hill
\bbridge\b	bro
\bbrygge\b	jetty
\bbukten\b	bay
\bcastle\b	borg
\bflaten\b	flate
\bnordre\b	n
\bparken\b	park
\bsquare\b	torg
\bstrede\b	strait
\bstreet\b	g
\btorget\b	torg
\bvalley\b	dal
\bvestre\b	w
\balley\b	lane
\bbakke\b	hill
\bdalen\b	dal
\bfleet\b	flate
\bgaten\b	g
\bloype\b	sti
\bplace\b	pl
\bplass\b	pl
\brampe\b	ramp
\broute\b	rute
\bsaint\b	st
\bsankt\b	st
\bslott\b	borg
\bsving\b	turn
\bvegen\b	g
\bveien\b	v
\bbukt\b	bay
\bbyen\b	by
\bcity\b	by
\bgata\b	g
\bgate\b	g
\blien\b	li
\bnord\b	n
\bpath\b	sti
\bquay\b	kai
\broad\b	g
\bvall\b	dal
\bvest\b	w
\båtte\b	8
\båtti\b	8
\blia\b	li
\bost\b	e
\bsor\b	s
\bsyd\b	s
\bveg\b	g
\bvei\b	v
\bway\b	v
\bgt\b	g
\bv\.\b	g
\bvg\b	g
\bvn\b	g
