\b([a-z]+)(alle|aveny|fil|gardsplan|gata(n)?|grand|korfalt|stig(en)?|brink(en)?|plats(en)?|straket|torg(et)?|torp)\b	\1 \2
\b([a-z]+)(korbana|rutt|terrass|vag(en)?)\b	\1 \2
\bvastra\s+goetalands\b	o
\bvastra\s+goetaland\b	o
\boestergoetlands\b	e
\bvasternorrlands\b	y
\bmotortrafikled\b	expressway
\boestergoetland\b	e
\bvastergoetland\b	e
\bvasternorrland\b	y
\bniagaravageen\b	niagaravagen
\bsodermanlands\b	d
\bvasterbottens\b	ac
\bjoenkoepings\b	f
\bsodermanland\b	d
\bvasterbotten\b	ac
\bvastmanlands\b	u
\bcarriageway\b	korbana
\bjoenkoeping\b	f
\bnorrbottens\b	bd
\bvastmanland\b	u
\besplanaden\b	esplanad
\bgavleborgs\b	x
\bkronobergs\b	g
\bnorrbotten\b	bd
\bpromenaden\b	walk
\bstockholms\b	ab
\bturistrutt\b	v
\bgardsplan\b	close
\bgavleborg\b	x
\bjamtlands\b	z
\bkronoberg\b	g
\boeverfart\b	passage
\boevergang\b	passage
\bstockholm\b	ab
\bstorgatan\b	storg
\bvarmlands\b	s
\bvidevagen\b	videv
\balleyway\b	g
\bblekinge\b	k
\bdalarnas\b	w
\bgoteborg\b	gbg
\bgotlands\b	i
\bhallands\b	n
\bjamtland\b	z
\bmotorway\b	motorvag
\boerebros\b	t
\boverfart\b	passage
\bovergang\b	passage
\bpromenad\b	walk
\bstranden\b	beach
\bterrasen\b	terrace
\btraverse\b	korsa
\bvarmland\b	s
\bavenyen\b	alle
\bbrinken\b	brink
\bbygatan\b	bygata
\bdalarna\b	w
\bgotland\b	i
\bgranden\b	alley
\bhalland\b	n
\bkorfalt\b	fil
\boerebro\b	t
\bplatsen\b	place
\bstraket\b	strak
\bsverige\b	se
\bterrass\b	terrace
\buppsala\b	c
\bavenue\b	alle
\bkalmar\b	h
\boestra\b	o
\bparken\b	park
\bsankta\b	s:t
\bsoeder\b	s
\bsoedra\b	s
\bsquare\b	torg
\bstigen\b	path
\bstrand\b	beach
\bstreet\b	g
\bsweden\b	se
\btorget\b	torg
\bvastra\b	v
\ballen\b	alle
\baveny\b	alle
\bcourt\b	close
\bgamla\b	g:a
\bgatan\b	g
\bgrand\b	alley
\bleden\b	led
\bliden\b	lid
\blilla\b	l
\bnorra\b	n
\bostra\b	o
\bplats\b	place
\broute\b	rutt
\bsankt\b	s:t
\bskane\b	m
\bsoder\b	s
\bsodra\b	s
\bsthlm\b	ab
\bstora\b	st
\bvagen\b	v
\bgata\b	g
\blane\b	fil
\bnorr\b	n
\boe:a\b	o
\boest\b	o
\broad\b	v
\bs:kt\b	s:t
\bs:ta\b	s:t
\bstig\b	path
\bvast\b	v
\bgam\b	g:a
\bn:a\b	n
\bo:a\b	o
\bost\b	o
\bs:a\b	s
\bswe\b	se
\bv:a\b	v
\bvag\b	v
\bway\b	v
