\blebuhraya\b	lbh
\bcrescent\b	cres
\bhighway\b	lbh
\bavenue\b	ave
\bcircle\b	cir
\blorong\b	ln
\bstreet\b	rd
\balley\b	ln
\bcourt\b	ct
\bdrive\b	dr
\bjalan\b	rd
\blebuh\b	lbh
\bnorth\b	n
\bplace\b	pl
\bsouth\b	s
\beast\b	e
\blane\b	ln
\bloop\b	lp
\broad\b	rd
\bwest\b	w
\bjln\b	rd
\blor\b	ln
\blrg\b	ln
\bst\b	rd
