\bnumarasi\s+binasinin\s+sayis\b	no
\bincorporated\b	inc
\bsokaklarin\b	s
\bgechelge\b	petik
\bsokaklar\b	s
\bbulvari\b	bl
\bcaddesi\b	cd
\bcikmazi\b	cikmaz
\bcompany\b	comp
\bkoprusu\b	kp
\bsirketi\b	comp
\bturkiye\b	tr
\banonim\b	inc
\bbulvar\b	bl
\bgecidi\b	gecit
\bsokagi\b	s
\btuneli\b	tnl
\bturkey\b	tr
\byokusu\b	yokus
\bcadde\b	cd
\bkoche\b	s
\bkopru\b	kp
\bsokak\b	s
\btunel\b	tnl
\bsite\b	sit
\byolu\b	yl
\bblv\b	bl
\bcad\b	cd
\bkpr\b	kp
\bsok\b	s
\byol\b	yl
\bbv\b	bl
\bsk\b	s
