\bjoint\s+base\s+elmendorf\s+richardson\b	jber
\bwashington\s+district\s+of\s+columbia\b	dc
\bfederated\s+states\s+of\s+micronesia\b	fm
\bjoint\s+base\s+pearl\s+harbor\s+hickam\b	jbphh
\bnational\s+forest\s+development\b	nat for dev
\bmartin\s+luther\s+king\s+junior\b	mlk
\barmed\s+forces\s+middle\s+east\b	ae
\bmarine\s+corps\s+base\s+hawaii\b	mcbh kanehoe bay
\bnational\s+for\s+development\b	nat for dev
\bnorthern\s+mariana\s+islands\b	mp
\bunited\s+states\s+of\s+america\b	us
\bmartin\s+luther\s+king\s+jnr\b	mlk
\bnat\s+forest\s+development\b	nat for dev
\barmed\s+forces\s+americas\b	aa
\bmartin\s+luther\s+king\s+jr\b	mlk
\barmed\s+forces\s+pacific\b	ap
\bcounty\s+truck\s+highway\b	cth
\bdistrict\s+of\s+columbia\b	dc
\barmed\s+forces\s+africa\b	ae
\barmed\s+forces\s+canada\b	ae
\barmed\s+forces\s+europe\b	ae
\bfarm\s+to\s+market\s+road\b	fm
\bnat\s+for\s+development\b	nat for dev
\bnational\s+forest\s+dev\b	nat for dev
\bjoint\s+reserve\s+base\b	jrb
\blincolns\s+new\s+salem\b	lincoln nw sl
\bmartin\s+luther\s+king\b	mlk
\bnational\s+monument\b	national mo
\bcolorado\s+springs\b	co spgs
\bdist\s+of\s+columbia\b	dc
\bfrancis\s+e\s+warren\b	fe warren
\bmarshall\s+islands\b	mh
\bnational\s+for\s+dev\b	nat for dev
\bwashington\s+state\b	wa
\bcharlottesville\b	charlottesvle
\badministration\b	admn
\bair\s+force\s+base\b	afb
\bamerican\s+samoa\b	as
\bbradford\s+woods\b	bradfordwoods
\bchristiansberg\b	christiansbrg
\bcrawfordsville\b	crawfordsvlle
\bfarm\s+to\s+market\b	fm
\bforest\s+service\b	frst srvc
\bfredericksburg\b	fredericksbrg
\bhendersonville\b	hendersonvlle
\bjeffersonville\b	jeffersonvlle
\bjohn\s+f\s+kennedy\b	jfk
\blittle\s+diomede\b	diomede
\bmechanicsville\b	mechanicsvlle
\bnat\s+forest\s+dev\b	nat for dev
\bnew\s+york\s+state\b	ny
\bnorth\s+carolina\b	nc
\bnorthumberland\b	northumberlnd
\broosevelt\s+road\b	rr
\bsalt\s+lake\s+city\b	slc
\bsouth\s+carolina\b	sc
\bvirgin\s+islands\b	vi
\bwashington\s+d\s+c\b	dc
\barmy\s+airfield\b	army af
\binternational\b	intl
\bjf\s+kennedy\s+ap\b	jfk airport
\bmassachusetts\b	ma
\bnational\s+park\b	ntpk
\bnew\s+hampshire\b	nh
\bnew\s+york\s+city\b	ny
\btownship\s+road\b	tr
\btownship_road\b	tr
\bunited\s+states\b	us
\bwashington\s+dc\b	dc
\bwest\s+virginia\b	wv
\bbristle\s+cone\b	bristlecone
\bforest\s+route\b	frst rte
\bfrst\s+service\b	frst srvc
\bminers\s+mills\b	miners mill
\bnorth\s+dakota\b	nd
\bpennsylvania\b	pa
\brhode\s+island\b	ri
\bsouth\s+dakota\b	sd
\bswan\s+quarter\b	swanquarter
\bwhippoorwill\b	whipoorwill
\bbloomington\b	blmngtn
\bchevy\s+chase\b	chevy chs
\bclutch\s+city\b	houston
\bcondominium\b	condo
\bconnecticut\b	ct
\bforest\s+srvc\b	frst srvc
\bfrenchville\b	frnchvl
\bgood\s+fellow\b	goodfellow
\bhigh\s+bridge\b	highbridge
\blos\s+angeles\b	la
\bloxahatchee\b	lox
\bmississippi\b	ms
\bobservatory\b	obs
\bpuerto\s+rico\b	pr
\brural\s+route\b	rr
\bspringfield\b	spfld
\bstate\s+route\b	sr
\byellowstone\b	yelwstn
\balpen\s+glow\b	alpenglow
\bambassador\b	amb
\bapartmento\b	apt
\bbernardino\b	bernrdno
\bbloomfield\b	bloomfld
\bbrownstown\b	brownstwn
\bburlington\b	burlngtn
\bcalifornia\b	ca
\bcapistrano\b	capo
\bchristmass\b	chirstmas
\bcincinnati\b	cin
\bcottonwood\b	ctwd
\bcrossroads\b	xrds
\bexpressway\b	exp
\bextensions\b	exd
\bfarmington\b	farmingtn
\bforest\s+rte\b	frst rte
\bfrst\s+route\b	frst rte
\blightening\b	lightning
\bnew\s+jersey\b	nj
\bnew\s+mexico\b	nm
\bnorthsouth\b	ns
\bpittsburgh\b	pgh
\bplantation\b	plt
\bprovidence\b	providnce
\bsouth\s+lake\b	southlake
\bthroughway\b	trwy
\btrafficway\b	trfy
\buniversity\b	univ
\bwashington\b	wa
\bwest\s+point\b	westpoint
\bapartment\b	apt
\bbellerose\b	bellrs
\bboulevard\b	blvd
\bburlingtn\b	burlngtn
\bchair\s+bar\b	chairbar
\bchicester\b	chicstr
\bcity\s+base\b	cb
\bcleveland\b	cleve
\bcommunity\b	cmnty
\bcrossroad\b	xrd
\bextension\b	exd
\bfairmount\b	fairmt
\bfernandez\b	fdez
\bfrancisco\b	fran
\bfreestone\b	f
\bhawthorne\b	hawthorn
\bhighlands\b	hlds
\bho'olehua\b	hoolehua
\bhomestead\b	hmstd
\bjunctions\b	jt
\blexington\b	lxngtn
\blouisiana\b	la
\bmilwaukee\b	milw
\bminnesota\b	mn
\bmountains\b	mnt
\bnys\s+route\b	sr
\bpeninsula\b	penisula
\bpennisula\b	penisula
\brichfield\b	richfld
\bstravenue\b	stra
\btennessee\b	tn
\btown\s+line\b	t l
\bunderpass\b	upas
\bvan\s+zandt\b	vz
\bwashingtn\b	wa
\bwisconsin\b	wi
\banderson\b	an
\barkansas\b	ar
\bbig\s+bend\b	bg bnd
\bblooming\b	blmng
\bbuilding\b	bldg
\bbullrush\b	bulrush
\bbusiness\b	b
\bcauseway\b	cswy
\bcolorado\b	co
\bcottonwd\b	ctwd
\bcrescent\b	cres
\bcrossing\b	xing
\bcrossrds\b	xrds
\bdelaware\b	de
\beastwest\b	ew
\bhartford\b	hartfrd
\billinois\b	il
\bjunction\b	jt
\bkentucky\b	ky
\bla\s+salle\b	lasalle
\bmaryland\b	md
\bmaverick\b	mavrick
\bmemorial\b	mem
\bmichelle\b	michele
\bmichigan\b	mi
\bmissouri\b	mo
\bmotorway\b	mtwy
\bmountain\b	mnt
\bnational\b	nl
\bnebraska\b	ne
\bnew\s+york\b	ny
\boklahoma\b	ok
\boverpass\b	opas
\bparkways\b	pkwys
\brichland\b	richlnd
\btownline\b	t l
\btownship\b	tp
\bturnpike\b	tpk
\bvillages\b	vil
\bvilliage\b	vil
\bvirginia\b	va
\balabama\b	al
\bamerica\b	us
\barizona\b	az
\bavenida\b	av
\bcapitol\b	capital
\bcausway\b	cswy
\bcenters\b	cen
\bchicago\b	chgo
\bcircles\b	cir
\bcollege\b	clg
\bcolonel\b	col
\bcommons\b	cmn
\bcorners\b	cor
\bcountry\b	cntry
\bcrecent\b	cres
\bcresent\b	cres
\bcrossrd\b	xrd
\bcrssing\b	xing
\bestates\b	est
\bexpress\b	exp
\bflorida\b	fl
\bforests\b	frst
\bforrest\b	frst
\bfreeway\b	fwy
\bgardens\b	gdn
\bgateway\b	gtwy
\bgeorgia\b	ga
\bharbors\b	hbr
\bharbour\b	hbr
\bheights\b	ht
\bhighway\b	hw
\bhollows\b	hllw
\bindiana\b	in
\bislands\b	is
\bjohnson\b	jhnsn
\bjuncton\b	jt
\blanding\b	lnd
\bmeadows\b	mdw
\bmission\b	msn
\bmontana\b	mt
\bmountin\b	mnt
\borchard\b	orch
\bparkway\b	pky
\bpassage\b	psge
\bphoenix\b	phx
\bplaines\b	pln
\bpotsdam\b	potsdm
\bprairie\b	pr
\branches\b	rch
\branchos\b	rch
\bsprings\b	spg
\bsquares\b	sq
\bstation\b	sta
\bstraven\b	stra
\bstreets\b	st
\bstrvnue\b	stra
\bterrace\b	ter
\btownshp\b	tp
\btrailer\b	tr
\btunnels\b	tunl
\bvalleys\b	vl
\bvermont\b	vt
\bviaduct\b	via
\bvillage\b	vil
\bwilliam\b	wm
\bwshngtn\b	wa
\bwyoming\b	wy
\balaska\b	ak
\barcade\b	arc
\bavenue\b	av
\bbarrio\b	bo
\bbluffs\b	blf
\bbottom\b	bot
\bbranch\b	br
\bbridge\b	brg
\bbrooks\b	brk
\bbypass\b	byp
\bcamino\b	cm
\bcanyon\b	cyn
\bcarlin\b	carlan
\bcenter\b	cen
\bcentre\b	cen
\bcharge\b	chrg
\bcircle\b	cir
\bcliffs\b	clf
\bcommon\b	cmn
\bcorner\b	cor
\bcorpus\b	crp
\bcourse\b	crse
\bcourts\b	cts
\bcrscnt\b	cres
\bcrsent\b	cres
\bcrssng\b	xing
\bdesert\b	dsrt
\bdivide\b	dv
\bdrives\b	dr
\bestate\b	est
\bextnsn\b	exd
\bfields\b	fld
\bforest\b	frst
\bforges\b	frg
\bfreewy\b	fwy
\bgarden\b	gdn
\bgatewy\b	gtwy
\bgatway\b	gtwy
\bgrande\b	grnd
\bgreens\b	grn
\bgroves\b	grv
\bhangar\b	hngr
\bhanger\b	hngr
\bharbor\b	hbr
\bhawaii\b	hi
\bheight\b	ht
\bhighwy\b	hw
\bhollow\b	hllw
\bisland\b	is
\bislnds\b	is
\bjction\b	jt
\bjunctn\b	jt
\bkansas\b	ks
\bknolls\b	knl
\blagoon\b	lagn
\blights\b	lgt
\blittle\b	ltl
\bmanors\b	mnr
\bmarion\b	ma
\bmeadow\b	mdw
\bmedows\b	mdw
\bmeyers\b	myers
\bmiddle\b	mid
\bmntain\b	mnt
\bnevada\b	nv
\bobispo\b	obisp
\boffice\b	ofc
\borchrd\b	orch
\boregon\b	or
\bparcel\b	prcl
\bparkwy\b	pky
\bplains\b	pln
\bpointe\b	pt
\bpoints\b	pt
\bpuerto\b	pto
\bquarry\b	qry
\bradial\b	rad
\bradiel\b	rad
\branchs\b	rch
\brapids\b	rpd
\bridges\b	rdg
\bschool\b	sch
\bsenior\b	sr
\bshoals\b	shl
\bshoars\b	shr
\bshores\b	shr
\bskyway\b	skwy
\bsloope\b	sloop
\bspring\b	spg
\bsprngs\b	spg
\bsquare\b	sq
\bstrave\b	stra
\bstravn\b	stra
\bstream\b	strm
\bstreet\b	st
\bstreme\b	strm
\bsumitt\b	smt
\bsummit\b	smt
\bsydney\b	sidney
\btraces\b	trce
\btracks\b	trk
\btrails\b	tr
\btunnel\b	tunl
\bturnpk\b	tpk
\btwnshp\b	tp
\bunions\b	un
\bvalley\b	vl
\bviadct\b	via
\bvillag\b	vil
\bwaters\b	wtr
\bxroads\b	xrds
\ba\s+f\s+b\b	afb
\ballee\b	aly
\balley\b	aly
\bannex\b	anx
\bavenu\b	av
\bavnue\b	av
\bbayoo\b	byu
\bbayou\b	byu
\bbeach\b	bch
\bblack\b	blk
\bbluff\b	blf
\bbottm\b	bot
\bboulv\b	blvd
\bbrdge\b	brg
\bbrnch\b	br
\bbrook\b	brk
\bburgs\b	bg
\bbypas\b	byp
\bcalif\b	ca
\bcalle\b	cll
\bcanyn\b	cyn
\bcentr\b	cen
\bcircl\b	cir
\bcliff\b	clf
\bcnter\b	cen
\bcourt\b	ct
\bcoves\b	cv
\bcrcle\b	cir
\bcreek\b	ck
\bcrest\b	cres
\bcrsnt\b	cres
\bcurve\b	curv
\bdepot\b	dep
\bdrive\b	dr
\bfalls\b	fls
\bferry\b	fry
\bfield\b	fld
\bflats\b	flt
\bfords\b	frd
\bforge\b	frg
\bforks\b	fks
\bfront\b	frnt
\bfrway\b	fwy
\bgardn\b	gdn
\bglens\b	gln
\bgrand\b	grnd
\bgrden\b	gdn
\bgrdns\b	gdn
\bgreen\b	grn
\bgrove\b	grv
\bgtway\b	gtwy
\bharbr\b	hbr
\bhaven\b	hvn
\bhills\b	hl
\bhiway\b	hw
\bholws\b	hllw
\bhouse\b	hse
\bhrbor\b	hbr
\bidaho\b	id
\binlet\b	inlt
\bisles\b	isle
\bislnd\b	is
\bjctns\b	jt
\bknoll\b	knl
\blakes\b	lk
\blanes\b	la
\blight\b	lgt
\blndng\b	lnd
\blocks\b	lck
\blodge\b	ldg
\bloops\b	loop
\blower\b	lo
\bm\s+l\s+k\b	mlk
\bmaine\b	me
\bmanor\b	mnr
\bmem'l\b	mem
\bmills\b	ml
\bmissn\b	msn
\bmntns\b	mnt
\bmount\b	mt
\bn\s+y\s+c\b	ny
\bnorte\b	n
\bnorth\b	n
\boeste\b	w
\bpalau\b	pw
\bpalms\b	plm
\bparks\b	pk
\bpaseo\b	pso
\bpaths\b	path
\bpikes\b	pike
\bpines\b	pne
\bpkway\b	pky
\bplace\b	pl
\bplain\b	pln
\bplaza\b	plz
\bpoint\b	pt
\bponds\b	pnds
\bports\b	prt
\brains\b	rs
\branch\b	rch
\brapid\b	rpd
\bridge\b	rdg
\briver\b	riv
\brncho\b	rch
\brnchs\b	rch
\broads\b	rd
\broute\b	rt
\bsaint\b	st
\bshoal\b	shl
\bshoar\b	shr
\bshore\b	shr
\bsouth\b	s
\bspace\b	sp
\bspngs\b	spg
\bsprgs\b	spg
\bsprng\b	spg
\bspurs\b	spur
\bstatn\b	sta
\bstrav\b	stra
\bstrvn\b	stra
\bsuite\b	ste
\bsumit\b	smt
\btexas\b	tx
\btrace\b	trce
\btrack\b	trk
\btrail\b	tr
\btrnpk\b	tpk
\btunel\b	tunl
\btunls\b	tunl
\btunnl\b	tunl
\bu\s+s\s+a\b	us
\bunion\b	un
\bupper\b	uppr
\bvally\b	vl
\bverdi\b	verde
\bviews\b	vw
\bville\b	vl
\bvillg\b	vil
\bvista\b	vis
\bwalks\b	walk
\bwells\b	wl
\bwoods\b	wds
\bworks\b	wks
\bxroad\b	xrd
\bally\b	aly
\banex\b	anx
\bariz\b	az
\baven\b	av
\bbend\b	bnd
\bblfs\b	blf
\bbluf\b	blf
\bboul\b	blvd
\bbrks\b	brk
\bbuoy\b	bouy
\bburg\b	bg
\bbyng\b	bing
\bbypa\b	byp
\bbyps\b	byp
\bcamp\b	cp
\bcape\b	cpe
\bcent\b	cen
\bcirc\b	cir
\bcirs\b	cir
\bcity\b	cy
\bclfs\b	clf
\bclub\b	clb
\bcmns\b	cmn
\bcntr\b	cen
\bcnyn\b	cyn
\bcolo\b	co
\bconn\b	ct
\bcors\b	cor
\bcove\b	cv
\bcrcl\b	cir
\bcrst\b	cres
\bctrs\b	cen
\bdale\b	dl
\bdriv\b	dr
\beast\b	e
\beste\b	e
\bests\b	est
\bexpr\b	exp
\bexpw\b	exp
\bexpy\b	exp
\bextd\b	exd
\bextn\b	exd
\bexts\b	exd
\bfarm\b	frm
\bflat\b	flt
\bflds\b	fld
\bflts\b	flt
\bford\b	frd
\bforg\b	frg
\bfork\b	fks
\bfort\b	ft
\bfrds\b	frd
\bfrgs\b	frg
\bfrks\b	fks
\bfrry\b	fry
\bfrwy\b	fwy
\bgdns\b	gdn
\bglen\b	gln
\bglns\b	gln
\bgrdn\b	gdn
\bgrns\b	grn
\bgrov\b	grv
\bgrvs\b	grv
\bguam\b	gu
\bharb\b	hbr
\bhavn\b	hvn
\bhbrs\b	hbr
\bhght\b	ht
\bhgts\b	ht
\bhill\b	hl
\bhiwy\b	hw
\bholw\b	hllw
\bhway\b	hw
\biowa\b	ia
\bjctn\b	jt
\bjcts\b	jt
\bjnct\b	jt
\bkans\b	ks
\bkeys\b	ky
\bknls\b	knl
\bknol\b	knl
\blake\b	lk
\blane\b	la
\blcks\b	lck
\bldge\b	ldg
\blgts\b	lgt
\blitl\b	ltl
\blndg\b	lnd
\bloaf\b	lf
\block\b	lck
\blodg\b	ldg
\bmass\b	ma
\bmdws\b	mdw
\bmeml\b	mem
\bmich\b	mi
\bmile\b	mle
\bmill\b	ml
\bminn\b	mn
\bmiss\b	ms
\bmnrs\b	mnr
\bmntn\b	mnt
\bmssn\b	msn
\bmtin\b	mnt
\bmtns\b	mnt
\bnebr\b	ne
\bneck\b	nck
\bohio\b	oh
\bokla\b	ok
\boreg\b	or
\boval\b	ovl
\bpalm\b	plm
\bpark\b	pk
\bpass\b	ps
\bpine\b	pne
\bpkwy\b	pky
\bplms\b	plm
\bplns\b	pln
\bplza\b	plz
\bpnes\b	pne
\bport\b	prt
\bprts\b	prt
\bradl\b	rad
\brdge\b	rdg
\brdgs\b	rdg
\brest\b	rst
\brivr\b	riv
\brnch\b	rch
\broad\b	rd
\broom\b	rm
\brpds\b	rpd
\bshls\b	shl
\bshrs\b	shr
\bspgs\b	spg
\bspng\b	spg
\bsprg\b	spg
\bsqre\b	sq
\bsqrs\b	sq
\bstrt\b	st
\bsuit\b	ste
\btenn\b	tn
\bterr\b	ter
\btown\b	tn
\btpke\b	tpk
\btrak\b	trk
\btrks\b	trk
\btrlr\b	tr
\btrls\b	tr
\btrpk\b	tpk
\btwln\b	t l
\btwsp\b	tp
\bunit\b	u
\butah\b	ut
\bvdct\b	via
\bview\b	vw
\bvill\b	vil
\bvist\b	vis
\bvlgs\b	vil
\bvlly\b	vl
\bvlys\b	vl
\bvsta\b	vis
\bwash\b	wa
\bways\b	wy
\bwell\b	wl
\bwest\b	w
\bx\s+rd\b	xrd
\bala\b	al
\bark\b	ar
\bave\b	av
\bavn\b	av
\bbgs\b	bg
\bbtm\b	bot
\bbus\b	b
\bcam\b	cm
\bcmp\b	cp
\bcrk\b	ck
\bcrt\b	ct
\bctr\b	cen
\bcty\b	cy
\bcvs\b	cv
\bd\s+c\b	dc
\bdam\b	dm
\bdiv\b	dv
\bdpt\b	dep
\bdrs\b	dr
\bdrv\b	dr
\bdvd\b	dv
\bext\b	exd
\bfla\b	fl
\bfrk\b	fks
\bfrt\b	ft
\bhei\b	ht
\bhls\b	hl
\bhts\b	ht
\bhwy\b	hw
\bill\b	il
\bind\b	in
\bisl\b	is
\biss\b	is
\bjct\b	jt
\bkan\b	ks
\bkey\b	ky
\bkys\b	ky
\bl\s+a\b	la
\blke\b	lk
\blks\b	lk
\blwr\b	lo
\bmls\b	ml
\bmtn\b	mnt
\bn\s+c\b	nc
\bn\s+d\b	nd
\bn\s+h\b	nh
\bn\s+j\b	nj
\bn\s+m\b	nm
\bn\s+y\b	ny
\bneb\b	ne
\bnev\b	nv
\bnte\b	n
\bnth\b	n
\bntl\b	nl
\bnyc\b	ny
\bnys\b	ny
\bore\b	or
\bp\s+r\b	pr
\bprk\b	pk
\bprr\b	pr
\bpts\b	pt
\br\s+i\b	ri
\brds\b	rd
\brte\b	rt
\brvr\b	riv
\bs\s+c\b	sc
\bs\s+d\b	sd
\bsan\b	sn
\bspc\b	sp
\bspr\b	spg
\bsqr\b	sq
\bsqs\b	sq
\bsqu\b	sq
\bsth\b	s
\bstn\b	sta
\bstr\b	st
\bsts\b	st
\bsur\b	s
\btex\b	tx
\btlr\b	tr
\btrl\b	tr
\btwp\b	tp
\bu\s+s\b	us
\buns\b	un
\busa\b	us
\bv\s+i\b	vi
\bvlg\b	vil
\bvly\b	vl
\bvst\b	vis
\bvws\b	vw
\bw\s+v\b	wv
\bway\b	wy
\bwis\b	wi
\bwls\b	wl
\bwva\b	wv
\bcr\b	ck
\bhy\b	hw
\bln\b	la
\btw\b	tp
\bvy\b	vl
